Algeria: بالشعب و للشعب (Arabic, By the people and for the people)
Andorra: Virtus, Unita, Fortior (Latin, Virtue, Unity, Strength)
Antigua and Barbuda: Each endeavouring, all achieving
Argentina: En Unión y Libertad (Spanish, In Union and Liberty)
Australia: None. Formerly Advance Australia)
Austria: None. Formerly AEIOU, with one possible meaning being Austriae est imperare orbi universo (Latin, It is Austria's destiny to rule the world)
Austria-Hungary: Indivisibiliter ac Inseparabiliter (Latin, Indivisible and inseparable) 
Bahamas: Forward, Upward, Onward Together
Barbados: Pride and Industry
Belgium: Eendracht maakt macht, L'union fait la force and Einigkeit gibt Stärke (Dutch, French and German, Unity gives Strength)
Belize: Sub umbra floreo (Latin, Under the shade I flourish)
Benin: Fraternité, Justice, Travail (French, Fellowship, Justice, Labour)
Bermuda: "Quo fata ferunt" (latin) wither the fates carry us
Bolivia: La Unión es la Fuerza (Spanish, Unity is Strength)
Botswana: Pula (Tswana, Rain)
Brazil: Ordem e progresso (Portuguese, Order and progress)
Brunei: Always in service with God's guidance
Bulgaria: Съединението прави силата (Bulgarian, The Unity makes the strength)
Burkina Faso: Unité, Progrès, Justice (French, Unity, Progress, Justice)
Burundi: Unité, Travail, Progrès (French, Unity, Work, Progress)
Cambodia: Nation, Religion, King
Cameroon: Paix - Travail - Patrie (French, Peace, Work, Fatherland)
Canada: A mari usque ad mare (Latin, From sea to sea)
Central African Republic: Unité, Dignité, Travail (French, Unity, Dignity, Work)
Chad: Unité, Travail, Progrès (French, Unity, Work, Progress)
Chile: Por la razón o la fuerza (Spanish, By reason or by strength)
Colombia: Libertad y orden (Spanish, Freedom and order)
Comoros: Unité, Justice, Progrès (French, Unity, justice, progress)
Confederate States of America: Deo Vindice (Latin, Under God, Our Vindicator)
Democratic Republic of the Congo: Justice - Paix - Travail (French, Justice, Peace, Work)
Republic of the Congo: Unité, Travail, Progrès (French, Unity, Work, Progress)
Costa Rica: Vivan siempre el trabajo y la paz (Spanish, Long live work and peace)
Côte d'Ivoire: Union, Discipline, Travail (French, Unity, Discipline, Labor)
Croatia: Bog i Hrvati(Croatian, God and Croats)
Croatia: Vjera u Boga i hrvatska sloga (Croatian, Trust in God and croatian unity)
Cuba: Patria o muerte (Spanish, Homeland or death)
Czech Republic: Pravda vítězí! (Czech, Truth prevails!)
Denmark: None. Motto of Queen Margrethe II: Guds hjælp, Folkets kærlighed, Danmarks styrke (Danish, God's help, the love of the people, Denmark's strength)
Djibouti: Unity, Equality, Peace
Dominica: Après le Bondie, C'est la Ter (French Patois, After the Good Lord, we love the Earth)
Dominican Republic: Dios, Patria, Libertad (Spanish, God, Country, Liberty)
East Timor: Honra, pátria e povo (Portuguese, Honour, homeland and people)
Ecuador: Dios, patria y libertad (Spanish, God, homeland and liberty)
El Salvador: Dios, Unión, Libertad (Spanish, God, Union, Liberty)
Equatorial Guinea: Unidad, Paz, Justicia (Spanish, Unity, Peace, Justice)
European Union: In varietate concordia (Latin for United in diversity, Unie dans la diversité, etc.Translated into the languages of the member states of the EU)
Fiji: Rerevaka na Kalou ka Doka na Tui (Fijian, Fear God and honour the Queen)
France: Liberté, égalité, fraternité (French, Liberty, equality, brotherhood)
Gabon: Union, Travail, Justice (French, Union, Work, Justice)
Gambia: Progress, Peace, Prosperity
Georgia: ძალა ერთობაშია! (Dzala ertobashia) (Georgian, Strength is in Unity)
Germany: Einigkeit und Recht und Freiheit (German, Unity and Justice and Freedom)
Ghana: Freedom and Justice
Greece: Ελευθερία ή θάνατος (transliterated as Eleutheria i thanatos) (Greek: Liberty or death, Freedom or Death)
Greece: Ισχύς Μου Η Αγάπη Του Λαού (transliterated as Ischis Mou I Agapi Tou Laou) (Greek: My Power [is] the Love of the People), Royal Motto under the Glücksburg dynasty
Greece: Patris, Thriskeia, Oikogeneia (Greek: Fatherland, Religion, Family) (during the Greek military junta of 1967-1974)
Grenada: Ever Conscious of God We Aspire, and Advance as One People
Guatemala: Libre Crezca Fecundo (Spanish: Grow Free and Fertile)
Guinea: Travail, Justice, Solidarité (French, Work, Justice, Solidarity)
Guinea-Bissau: Unidade, Luta, Progresso (Portuguese, Unity, Struggle, Progress)
Guyana: One people, one nation, one destiny
Haiti: L'union fait la force (French, Unity makes strength)
Honduras: Libre, Soberana E Independiente(Spanish, Free, sovereign and independent)
Hungary: None. Formerly Regnum Mariae Patrona Hungariae (Latin, Kingdom of Mary, the Patron of Hungary)
Iceland: Með lögum skal land byggja (Upon law shall a country be built)
India: सत्यमेव जयते (Satyameva Jayate) (Sanskrit, Truth alone triumphs)
Indonesia: Bhinneka Tunggal Ika (Old Javanese, Unity in diversity)
Iran: de facto: Esteqlāl, āzādī, jomhūrī-ye eslāmī (Persian, Independence, freedom, (the) Islamic Republic)
Iran: de jure: Allaho Akbar (Arabic, God is Great)
Iran: The imperial motto, before the Islamic revolution, was Marā dād farmūd-o khod dāvar ast (Persian, Justice He bids me do, as He will judge me).
Iraq: الله أكبر (Allahu Akbar) (Arabic, God is Great)
Jamaica: Out of many, one people
Jordan: الله الوطن المليك (Allah, Alwattan, Almaleek) God, country, sovereign
Kenya: Harambee (Swahili, Let's work together)
Kiribati: Te mauri, te raoi ao te tabomoa (Kiribati, Health, Peace and Prosperity)
North Korea: 강성대국 (强盛大國, Gang Seong Dae Guk) (Korean, Prosperous and great country)
South Korea: 홍익인간 (弘益人間, Hong Ik In Gan) (Korean, Benefit all mankind)
Laos: Peace, independence, democracy, unity and prosperity
Latvia: Tēvzemei un Brīvībai (Latvian, For Fatherland and Freedom)
Lesotho: Khotso, Pula, Nala (Sotho, Peace, Rain, Prosperity)
Lebanon: All for our nation
Liberia: The love of liberty brought us here
Liechtenstein: Für Gott, Fürst und Vaterland (German, For God, Prince and Fatherland)
Lithuania: Tautos jėga vienybėje (Lithuanian, The strength of the nation lies in unity)
Luxembourg: Mir wëlle bleiwe wat mir sinn (Luxembourgish, We wish to remain what we are)
Macedonia: Слобода или Смрт (Sloboda ili Smrt)- Freedom or Death
Madagascar: Tanindrazana, Fahafahana, Fandrosoana (Malagasy, Ancestral-land, Liberty, Progress)
Malawi: Unity and Freedom
Malaysia: Bersekutu Bertambah Mutu (Malay, Unity is Strength)
Mali: Un peuple, un but, une foi (French, One people, one goal, one faith)
Mauritania: شرف إخاء ع or Honneur, Fraternité, Justice (Arabic and French, Honor, Fraternity, Justice)
Mauritius: Stella Clavisque Maris Indici (Latin, Star and key of the Indian Ocean)
Monaco: Deo juvante (Latin, With God's help)
Montenegro: Čojstvo i junaštvo / Чојство и јунаштво (Serbian, Manliness and heroism )
Morocco: الله، الوطن، الملك (Arabic, God, the Country, the King)
Namibia: Unity, liberty, justice
Nauru: God's will first
Nepal: जननी जन्मभूमिष्च स्वर्गादपि गरियसि (Sanskrit, Mother and motherland are greater than heaven)
Netherlands: Je maintiendrai, Ik zal handhaven (French, Dutch I will stand fast)
Nicaragua: En Dios Confiamos (Spanish, In god we trust)
Niger: Fraternité, Travail, Progrès (French, Fraternity, Work, Progress)
Nigeria: Unity and Faith, Peace and Progress
Norway: None. Royal motto: Alt for Norge (Norwegian, Everything for Norway)
Pakistan: Ittihad, Yaqeen-mukkam, Nizam (Urdu, Unity, Faith, Discipline)
Panama: Pro mundi beneficio (Latin, For the benefit of the world)
Papua New Guinea: Unity in Diversity
Paraguay: Paz y justicia (Spanish, Peace and justice)
Philippines: Maka-Diyos, Maka-Tao, Makakalikasan at Makabansa (Tagalog, For God, People, Nature and Country)
Philippines: Former: Isang bansa, isang diwa (Tagalog, One nation, one spirit)
Poland: no official motto (see Unofficial mottos of Poland).
Roman Republic and Roman Empire: Senatus Populusque Romanus (Latin, The Senate and people of Rome, often abbreviated SPQR)
Romania: None. Formerly Nihil Sine Deo (Latin, Nothing without God)
Rwanda: Unity, Work, Patriotism
Sahrawi Arab Democratic Republic: حرية ديمقراطية وحدة (Hassānīya Arabic, Liberty, Democracy, Unity)
Saint Kitts and Nevis: Country Above Self
Saint Lucia: The land, the people, the light
Saint Vincent and the Grenadines: Pax et justitia (Latin, Peace and justice)
Samoa: Fa'avae i le Atua Samoa (Samoan, God be the Foundation of Samoa)
San Marino: Libertas (Latin, Liberty)
Saudi Arabia: لا إله إلا الله محمد رسول الله (lā ilāhā illā-llāhu; muhammadu-r-rasūlu-llāhi) (Arabic, (from the shahada) There is no god but Allah and Muhammad is His Prophet)
Senegal: Un peuple, un but, une foi (French, One people, one goal, one faith)
Serbia: Само Слога Србина Спашава (Serbian), "Only Unity Saves the Serbs"
Seychelles: Finis coronat opus (Latin, The end crowns the work)
Sierra Leone: Unity, freedom, justice
Singapore: Majulah Singapura (Malay, Onward Singapore)
Slovakia: Afferant Montes Pacem Populo (Latin, May mountains bring people peace)
Solomon Islands: To lead is to serve
South Africa: !ke e: /xarra //ke (/Xam, Diverse people unite or Unity in Diversity)
South Africa: Former: Ex Unitate Vires (Latin, From unity, strength, from 1910-2000)
Soviet Union: Пролетарии всех стран, соединяйтесь! (Russian, Proletarians of all countries, unite!)
Spain: Plus Ultra (Latin, Further beyond)
Spain: Former: Una, grande y libre (Spanish, One, great and free, during Spanish State)
Sudan: النصر لن (Al-Nasr Lana: Arabic, Victory is Ours)
Suriname: Justitia, pietas, fides (Latin, Justice, piety, loyalty)
Swaziland: Siyinqaba (Swati, We are the fortress)
Sweden: royal motto: För Sverige - i tiden (Swedish, For Sweden - With the times) (See all royal mottos)
Switzerland: Unus pro omnibus, omnes pro uno (Latin: One for all, all for one...(traditional, but not official))
Syria: Wahdah, Hourriah, Ishtirakiah (Arabic, Unity, Freedom, Socialism) Ba'th Party motto
Tanzania: Uhuru na Umoja (Swahili, Freedom and Unity)
Thailand: ชาติ ศาสนา พระมหากษัตริย์ (Thai, Nation, Religion, King)
Togo: Travail, Liberté, Patrie (French, Work, liberty, homeland)
Tonga: Ko e ʻOtua mo Tonga ko hoku tofiʻa (Tongan, God and Tonga are my Inheritance)
Trinidad and Tobago: Together we aspire, together we achieve
Tunisia: Order, Freedom, and Justice
Turkey: Egemenlik kayıtsız şartsız milletindir. (Turkish, Sovereignty rests unconditionally with the nation)
Turkey: Yurtta sulh, cihanda sulh. (Turkish, Peace in the homeland, peace in the world.)
Tuvalu: Tuvalu mo te Atua (Tuvaluan, Tuvalu for the Almighty)
Uganda: For God and My Country
United Kingdom: Dieu et mon droit (French, God and my right, Royal motto)
United States: In God We Trust (official) 
United States: E pluribus unum (Latin, Out of many, one) (de-facto)
Uruguay: Libertad o Muerte (Spanish, "Liberty or Death")
Vanuatu: Long God yumi stanap (Bislama, Let us stand firm in God)
Venezuela: Dios y Federación (Spanish, God and Federation)
Vietnam: Ðộc lập, tự do, hạnh phúc (Vietnamese, Independence, Liberty and Happiness)
Yugoslavia: Bratstvo i jedinstvo (Brotherhood and unity)
Zambia: One Zambia, One country
Zimbabwe: Unity, Freedom, Work
